'bout	about
'em	them
a'ight	all right
aggro	angry
aight	all right
alrighty	all right
amped up	excited
bestie	best friend
bezzie	best
boo boo	darling
bousta	about to
bout	about
buncha	bunch of
c'mon	come on
cause	because
coulda	could have
coz	because
cud	could
cuz	because
d	the
dat	that
deffo	definitely
defo	definitely
delish	delicious
dis	this
dontcha	don't you
dunzo	done
fella	fellow, man
goneski	gone
gonna	going to
gotta	got to
gotsta	got to
gimme	give me
hella	very
idk	i do not know
i'ma	I'm going to
i'mma	I'm going to
innit	isn't it
juz	just
kinda	kind of
lemme	let me
lotsa	lots of
lotta	lot of
luv	love
musta	must have
n	and
neva	never
nothin	nothing
on fleek	looking good
oughta	ought to
outa	out of
outta	out of
plz	please
posta	supposed to
ppl	people
preggers	pregnant
r	are
s'more	some more
shoulda	should have
socko	excellent
sorta	sort of
spesh	special
thanx	thanks
tryina	trying to
tryna	trying to
trynna	trying to
u	you
ur	your
urs	yours
urself	yourself
wanky	pretentious
whatevs	whatever
woulda	would have
y	why
y'all	you all
yea	yes
yeah	yes
you betcha	absolutely
